1131112311
1        1
3  22    3
2  1     1
3        2
1331     3
4        4
5 5      5
6 4      4
4546454464