1131422311
1        1
3  22    2
4  1     4
3        3
1231     3
1        4
2 1      3
1 2      2
1511111121