1131112311
1        1
3  22222 3
2  1     1
3        2
1331112  3
4        4
5 5   4445
6 4      4
4546454464